1111111111111
10010000PE0C1
1111111111111