1111111111111
10010C00PE001
1111111111111