1111111111111
10010000000C1
1000011111001
1PE0110000001
111111111111